AccIll	TCCGGA
Acc65I	GGTACC
AgeI	ACCGGT
A/w441	GTGCAC
ApaI	GGGCCC
BalI	TGGCCA
BamHI	GGATCC
BbnI	GCATGC
BclI	TGATCA
BblII	AGATCT
BssHII	GCGCGC
Bst98I	CTTAAG
BstZI	CGGCCG
ClaI	ATCGAT
Csp45I	TTCGAA
DraI	TTTAAA
Eco47III	ACGGCT
Eco52I	CGGCCG
Eco72I	CACGTG
EcoRI	GAATTC
EcoRV	GATATC
HindIII	AAGCTT
HpaI	GTTAAC
KpnI	GGTACC
MlnI	ACGCGT
NaeI	GCCGGC
NarI	GGCGCC
NcoI	CCATGG
NdeI	CATATG
NgoMI	GCCGGC
NheI	GCTAGC
NruI	TCGCGA
NsiI	ATGCAT
PstI	CTGCAG
PvuI	CGATCG
RvuII	CAGCTG
SacI	CCGCGG
SacII	CCGCGG
SalI	GTCGAC
ScaI	AGTACT
SmaI	CCCGGG
SnaBI	TACGTA
SpeI	ACTAGT
SphI	GCATGC
SspI	AATATT
StuI	AGGCCT
XbaI	TCTAGA
XhoI	CTCGAG
XmaI	CCCGGG


